0000000000000000000000000000000000
0000000000000000000000000000000000
0000w00w00w00w00w00000000000000000
012230012230012230012230012230001p
550044004400550000440044005500002l
001222300012223000122230001222301p
001230012300123000012300123001232p
004440055500444000044400555004441l
6666666666666600000000000000000000
ab000ab000ab000ab00000ab000ab0002p
c0000c00000c0000c0000c0000000c001l
e000e000e000e000e000e000e000e0001p
f0000f0000f0000f00f0000f0000f0001l
d000d000d000d000d000d000d000d0002p
00000000x0000000000000000000000000
9000000000000000000000000000000000
